10000000e1
1110111111
1000111111
1110111111
1010000000
1010111010
1000000000
1010111111
1000000000
1111*11111